&#8233;Descriptive study that aimed to identify and compare the nurses&#8217; knowledge addressed to patterns of alcohol use and related issues.	&#8233;Estudio descriptivo que tuvo como objetivo: identificar y comparar el conocimiento de las enfermeras sobre los patrones de consumo de alcohol y los problemas relacionados.
'Convenience codes' [16.3% (95% CI: 15.8-16.7)] were coded more frequently in women and in those &#8805; 80 years; 'Memory impairment' [12.4% (95% CI: 12.0-12.8)], 'related diseases' [4.6% (95% CI: 4.4-4.8)] and 'intercurrent processes' [10.3% (95% CI: 9.9-10.6)] were used more in men and in persons < 80 years.	Los «códigos de conveniencia» (16,3% [IC 95%: 15,8-16,7]) se utilizaron más en mujeres y &#8805; 80 años; las «alteraciones de memoria» (12,4% [IC 95%: 12,0-12,8]), «enfermedades relacionadas» (4,6% [IC 95%: 4,4-4,8]) y «procesos intercurrentes» (10,3% [IC 95%: 9,9-10,6]) más en hombres y < 80 años.
(10), Clostridium difficile (10), other clostridia (12), and gram-positive cocci (22).	(10), Clostridium difficile (10), otros clostridios (12) y cocos gram-positivos (22).
(12.1%), and other gram-negative bacteria (9.9%).	(12,1%) y otras bacterias gram-negativas (9,9%).
(1997) were used by all. Those with MD are concerned about body size, lift weights 3-7 days a week, performed protein diets, sometimes they uses food supplements and steroids.	Aquellos con DM están preocupados por el tamaño corporal, levantan pesas de 3 a 7 días por semana, realizan dietas hiperproteicas y en ocasiones utilizan suplementos alimentarios y esteroides.
(56.6%), followed by Streptococci spp.	(56,6%), seguidos de Streptococci spp.
(8 strains: 25 percent) and Escherichia coli (4 strains: 12,5 percent).	(8 cepas: 25 porciento) y Escherichia coli (4 cepas: 12,5 porciento).
(9%). The antibiotic sensitivity profile of the two predominant pathogens included: Klebsiella pneumoniae (over 50% sensitivity to meropenem, imipenem, gentamicin, amikacin, piperacillin, and tazobactam), Staphylococcus aureus (resistant to erythromycin (66.0%), to oxacillin (77, 3%), and to penicillin (84.9%).(AU)	(9%). El perfil de sensibilidad de los dos patógenos predominantes fue: Klebsiella pneumoniae (más de 50% de sensibilidad a meropenem, imipenem, gentamicina, amikacina y piperacilina más tazobactam); Staphylococcus aureus (resistencia a eritromicina (66,0%), oxacilina (77, 3%), penicilina (84,9%).(AU)
(Evidence B) Therapeutic alternatives: It is recommended for the treatment and prevention of osteopenia - osteoporosis in transplant patients based on data from clinical evidence available from other study populations, such as in patients with chronic kidney disease.	Alternativas terapéuticas: Para el tratamiento y la prevención de la osteopenia-osteoporosis en pacientes trasplantados se recomienda basarse en los datos de evidencia clínica disponibles de otras poblaciones de estudio, como la de los pacientes con ERC.
(First 71hs). The global mortality index of our series was the 51, 85 percent, prevailing the dysfunction organic multiple syndrome (35, 71percent) (AU)	El índice de mortalidad global de nuestra serie fue de 51.85 por ciento, prevaleciendo el síndrome de disfunción orgánica múltiple (35.71 por ciento) (AU)
(Resistance to Methicillin in S. aureus was conducted using Mueller Hinton with 4% NaCl and oxacillin 6 µg/mL).	La resistencia a la meticilina en S. aureus se realizó usando Mueller Hinton con 4% de NaCl y oxacilina 6 µg/mL.
(Stegomyia) albopictus (Skuse) is an invasive species native to Southeast Asia.	(Stegomyia) albopictus (Skuse) es una especie invasora originaria del sudeste asiático.
05. The main factors of risk associated to the presence of markers for the illness renal chronicle, were: the diabetes mellitus, the arterial hypertension, the habit of smoking and the antinflamatory ingestion.	Los principales factores de riesgo asociados a la presencia de marcadores para la enfermedad renal crónica, fueron: la diabetes mellitus, la hipertensión arterial, el hábito de fumar y la ingestión de antinflamatorios.
1) quadrant localization: 100% concordance between US and surgery, 2) Parks classification concordance achieved in 73 patients (76,6%), 3) localization of the internal opening correlation in 91 cases (88,34%).	1) 100% de concordancia en localización por cuadrantes, 2) localización según Parks acuerdo en 73 pacientes (67,6%),3) localización del orificio interno: correlación en 91 pacientes (88,34%).
1,160 different institutional signatures, 58 different countries and 398 scientific journals were identified.	Se identificaron 1.160 firmas institucionales diferentes, 58 países y 398 revistas científicas.
1. Training to hydration: During prolonged exercise in heat stress, athletes incur in dehydration.	Entrenamiento de la hidratación: Es habitual la deshidratación en el ejercicio prolongado bajo estrés térmico.
1.3% risk of having metabolic syndrome.	El 1,3% presentan riesgo de padecer síndrome metabólico.
10 professionals of the nursing team of the unit had taken part.	10 profesionales del equipo de enfermería de la unidad participaron.
10 women who had received cardiac surgery participated in the study, all from a city in the Zona da Mata in the state of Minas Gerais, who gave accounts guided by the question: What is your day-to-day like, following the cardiac surgery?	Participaron del estudio 10 mujeres, poscirugía cardíaca, de un municipio de la Zona de la Mata del interior de Minas Gerais, que realizaron sus relatos norteados por la cuestión: ¿Cómo está su cotidiano después de la cirugía cardíaca?
10-year-old boy transferred to our hospital due to intraoperative finding at a different centre of a right flank tumor, without identification of cecal appendix.	Paciente varón de 10 años de edad derivado a nuestro hospital por el hallazgo intraoperatorio en otro centro de una tumoración en flanco derecho, sin identificación del apéndice cecal.
10.4% (N = 33) has ever used a controlled substance and 7.6% (N = 25) has consumed during the specialization.	El 10.4% (N=33) ha consumido alguna vez una sustancia controlada y 7.6% (N=25) las ha consumido durante la especialidad.
10.4% of CVCs and 19.2% of PUCs did not meet criteria for installation and / or maintenance at the time of monitoring.	Un 10,4 y 19,2% de los CVC y CUP, respectivamente, no cumplían con criterios de instalación y/o mantención al momento de la supervisión.
100 percent of the patients received conventional treatment, precocious feeding was used in 10 patients for 71,4.	El 100 por ciento de los pacientes recibieron tratamiento convencional, la alimentación precoz se utilizó en 10 pacientes para un 71,4 por ciento.
100% of subjects with lower back pain claimed that they never went to the cinema, while 80% of persons with headache stated that their pain interfered in their activity visiting my friends.	El 100% de los sujetos con lumbalgia afirmó nunca ir al cine. El 80% de las personas con cefalea manifestaron interferencia del dolor en la actividad visitar a sus amistades.
100% of the T1 ewes presented estrus, beginning at 38.4±9.56 h after sponge removal.	El 100% de las ovejas de T1 presentaron estro, iniciando a las 38.4 ± 9.56 h del retiro de esponjas.
107 in-depth interviews were carried out supplemented with psychometric questionnaires about substance abuse, acculturative stress, impact on life of the experience of homelessness and psychological distress.	Se realizaron 107 entrevistas en profundidad complementadas con cuestionarios psicométricos sobre abuso de sustancias, estrés aculturativo, impacto vital de la experiencia de dormir en la calle y sufrimiento psicológico.
11.4% E. coli strains were producers of extended-spectrum Beta-lactamases (ESBL).	Del total de E. coli 11,4% fueron productores de betalactamasas de espectro extendido (BLEE).
110 participants answered the BJW measures and evaluated how much a stray bullet victim (ingroup X outgroup) was to blame in a situation of cognitive load (low X high).	110 participantes respondieron las medidas de la CMJ y evaluaron la responsabilidad de una víctima (endogrupo X exogrupo) de bala perdida en una situación de carga cognitiva (baja X alta).
1113 medications were reconciled, of which 836 had justified discrepancies, 56 RE and 36 PIM.	Se conciliaron 1113 medicamentos, con 836 discrepancias justificadas, 56 EC y 36 MPI.
116 cases of people with reported suicideattempts in emergency rooms and educational institutions in the department ofHuila were studied.	Seestudiaron 116 personas reportadas con intento de suicidio en servicios de urgenciase instituciones educativas del departamento del Huila.
12 elderly cancer patients from a city in northwest Paraná were interviewed from November 2013 to February 2014.	Fueron entrevistados 12 ancianos en un municipio del noroeste de Paraná, en el período de noviembre de 2013 a febrero de 2014.
12 patients were companied along 5 one-hour sessions of hypnotherapy weakly.	Fueron acompañados 12 sujetos durante 5 sesiones de 1 hora de hipnoterapia escalonadas semanalmente.
125 pairs of matched radiographs for 1000 measurements were evaluated.	Se evaluaron 125 pares de radiografías para 1000 mediciones en total.
13 patients were treated by TVT in an outpatient basis (group 1, Department of Urology), 10 patients were treated by TOT with hospital admission (Group 2, Department of Gynaecology).	Trece (13) pacientes fueron tratadas en el servicio de urología (TVT - CMA) (Grupo 1) y 10 en el servicio de ginecología (TVT-O con ingreso)(Grupo 2).
13 patientshad nephrostomy drainage.	El 100 por ciento de los pacientes recibieron tratamiento convencional, la alimentación precoz se utilizó en 10 pacientes para un 71,4 por ciento.
13.2% did not perceive any risk in smoking, and 16.1% were unconcerned about the risks to passive smokers.	El 13,2% no percibe el riesgo del tabaco y al 16,1% no le preocupa sus efectos en el fumador pasivo.
136 patients with chronic periodontitis were included, selecting the worst prognosis teeth and two radiographs -conventional and digital- were taken for each one.	Se realizó un estudio de pruebas diagnósticas de consistencia en 136 pacientes con periodontitis crónica seleccionando el diente con peor pronóstico.
14 question quiz testing knowledge of heart disease and self-care, validated for use in Brazil, was used.	Fue aplicado un cuestionario, validado en Brasil, con 14 cuestiones, sobre el conocimiento de la enfermedad y del autocuidado.
14.3% did not provide the medical report and 18.0% applied it (61.7% for bureaucratic reasons and 28.0% for information).	El 14,3% no aporta informe médico y el 18,0% solicita uno (el 61,7% por trámites burocráticos y el 28,0% por información).
14.3% of the elderly evaluated reported having been diagnosed with diabetes mellitus, and of these, 48.7% had subjective findings of cognitive impairment (17.4% of total population with cognitive impairment).	El 14.3% de los ancianos evaluados refirieron haber sido diagnosticado con diabetes mellitus, de los cuales 48.7% presentaron hallazgos subjetivos de deterioro cognitivo (17.4% del total de población con deterioro cognitivo).
142 adult subjects of both sexes.	Participaron 142 sujetos de ambos sexos.
143 officially married or living together couples participated. Ages ranged between 19 and 81 years.	Participaron 143 parejas oficiales o que viven juntas, entre 19y 81 años.
15 medial menisci from eight albino rabbits of New Zealand breed were used, divided into three groups: five fresh menisci (GI); five menisci preserved in 98% glycerin for eight months (GII), and five menisci preserved in 98% glycerin for eight months and then rehydrated in 0.9% saline solution for 24 hours (GIII).	Se utilizaron 15 meniscos mediales, provenientes de ocho conejos de raza nueva zelanda albina, separados en tres grupos: cinco meniscos frescos (GI), cinco meniscos conservados por ocho meses en glicerina al 98% (GII) y cinco meniscos conservados por ocho meses en glicerina al 98% y rehidratados en solución salina 0,9%, por 24 horas (GIII).
15 nurses who participated in puerperium consultations in nine health units of the Sanitary District Cajuru the Municipal Health Secretariat from Curitiba / Paraná, Brazil.	Participaron 15 enfermeras que realizaban consultas de puerperio, en nueve unidades de salud del Distrito Sanitario Cajuru de la Secretaría Municipal de Salud de Curitiba/Paraná, Brasil.
15.7% of cryptogenic epilepsies and 14.1% of idiopathic epilepsies are refractory to treatment.	El 15,7% de las epilepsias criptogénicas y el 14,1% de las idiopáticas son refractarias al tratamiento.
150 hepatitis B chronic carriers samples have been used.	Se han usado 150 muestras de portadores crónicos del virus.
159 patients were included, 89 (56%) were women.	Se evaluaron 159 pacientes, 89 (56%) mujeres.
16 bibliographies (national and international) were reviewed for this paper with a publication interval of 10 years for books, and 5 years for journals.	Para la realización de este trabajo se revisaron bibliografías (nacionales e internacionales), con un intervalo de publicación de 10 años para los libros y de 5 años para las revistas.
16 nurses who had acquired relational skills through reflective practice were interviewed from a phenomenological approach.	Desde una aproximación fenomenológica se entrevistó a dieciséis enfermeras que habían adquirido competencias relacionales a través de la práctica reflexiva.
16 teachers, practitioners of physical and sporting activities in youth and that today no longer practice these activities, were interviewed.	Fueron entrevistados 16 profesores practicantes de actividades físicas y deportivas en la juventud y que ahora ya no practican más.
